111111
1C00C1
100P01
100001
1E0001
111111
