111111111111111111111
1C0000000000000P11111
111110000000000000001
100000001110000000001
100C00011110000C00001
1E0000000000110000001
111111111111111111111
