111111111111111111111
1C0000000000000P11111
1111100M0000000000001
1000000011100000M0001
100C00011110000C00001
1E0000000000110000001
111111111111111111111
