111111111111111111111111111111111111
1C0000000000000P00000000000000011111
1111100M0000000000000000C00000000001
1000000011100000M0000000000000000001
100C00011110000C00000000000000000001
100000000000110011100000000000000001
100000000000001111100000000C00000001
100000000000011110000000000000000001
100000011111011110000000000C00000001
10000001C000000000000000000000000001
100000011111100000M00001100000000001
100000000000100000000000111100000001
10111110000010M000000000000111100001
1000000000C01100000M0000C00000000001
101100000000000000000000000000000001
100000000000000011000000000111100001
1000C0000000000000000000001110000001
1000000000M000M0000000000000C0000001
10000C00000000000000000000000M000001
1011000000M000M00110000C000000000001
10E00M000000000000000000000000000001
111111111111111111111111111111111111
